#######
#.    #
#  $ .#
#  $@ #
#     #
#######