      XXX
      X.X
  XXXXX.XXXXX
 XX         XX
XX  X X X X  XX
X  XX     XX  X
X XX  X X  XX X
X     *@*     X
XXXX  XXX  XXXX
   XXXX XXXX