XXXXXXX
X. *  X
X    .XXXXXXXX
X  *@  *    .X
X            X
XXXXXXXXXXXXXX