#######
#. $  #
#    .########
#  $@  $    .#
#            #
##############