XXXXXXX  XXXXXXXX
X. *  X  X    . X
X    .XXXX      X
X  *@   *       X
X               X
XXXXXXXXXXXXXXXXX